XXXXXXXX
XPOOOXOX
XOXXOOOX
XOXOOOXX
XOOOOOEX
XXXXXXXX