XXXXXXXXXXXXXXXXXXXX
XOOOOOOOOEOOOOOOOOOX
XOOOOOOOOOOOOOOOOOOX
XOOOOOOOOOOOOOOOOOOX
XOOOOOOOOOOOOOOOOOOX
XOOOOOOOOOOOOOOOOOOX
XOOOOOOOOOOOOOOOOOOX
XOOOOOOOOOOOOOOOOOOX
XOOOOOOOOOOOOOOOOOOX
XOOOOOOOOOOOOOOOOOOX
XOOOOOOOOOOOOOOOOOOX
XOOOOOOOOOOOOOOOOOOX
XOOOOOOOOOOOOOOOOOOX
XOOOOOOOOOOOOOOOOOOX
XOOOOOOOOOOOOOOOOOOX
XOOOOPODDDDDOPOOOOOX
XOOOOOODOOODOOOOOOOX
XOOOOOODOMODOOOOOOOX
XOOOOOODOOODOOOOOOOX
XXXXXXXXXXXXXXXXXXXX