XXXXXXXXXXXXXXXXXXXX
XOOOOOOOOEOOOOOOOOOX
XOOOOOOOOOOOOOOOOOOX
XOODODOOOODOODOOWWOX
XOODODOOOODOODOOWWOX
XOODODOOOODOODOOWWOX
XOODDDDDOODOODOOWWOX
XOODODOOOODOODOOWWOX
XOODODODDDDDDDOOWWOX
XOODOOODOOOOOOOOWWOX
XOODOOODOOOOOOOOWWOX
XOODOOODOOOOOOOOWWOX
XOODOOODOOOOOOOOWWOX
XOOOOOOOOOOOOOOOWWOX
XOOOOOOOOOOOOOOOWWOX
XOOOOOOOOOOOOOOOWWOX
XOOOOPODDDDDOPOOOOOX
XOOOOOODOOODOOOOOOOX
XOOOOOODOMODOOOOOOOX
XOOOOOODOOODOOOOOOOX
XXXXXXXXXXXXXXXXXXXX