XXXXXXXXXXXXXXXXXXXX
XOOOOOOOOEOOOOOOOOOX
XOOOOOOOOOOOOOOOOOOX
XOOOOOOOOOOOOOOOWWOX
XOOOOOOOOOOOOOOOWWOX
XOOOOOOOOOOOOOOOWWOX
XOOOOOOOOOOOOOOOWWOX
XOOOOOOOOOOOOOOOWWOX
XOOOOOOOOOOOOOOOWWOX
XOOOOOOOOOOOOOOOWWOX
XOOOOOOOOOOOOOOOWWOX
XOOOOOOOOOOOOOOOWWOX
XOOOOOOOOOOOOOOOWWOX
XOOOOOOOOOOOOOOOWWOX
XOOOOOOOOOOOOOOOWWOX
XOOOOPODDDDDOPOOOOOX
XOOOOOODOOODOOOOOOOX
XOOOOOODOMODOOOOOOOX
XOOOOOODOOODOOOOOOOX
XXXXXXXXXXXXXXXXXXXX