XXXXXXXXXXXXXXXXXXX
XOOOOOOOOEOOOOOOOOX
XOOOOOOOOOOOOOOOOOX
XOOOOOOOOOOOOOOOOOX
XOOOOOOOOOOOOOOOOOX
XOOOOOOOOOOOOOOOOOX
XOOOOOOOOOOOOOOOOOX
XOOOOOOOOOOOOOOOOOX
XOOOOOOOOOOOOOOOOOX
XOOOOPOOOOOOOPOOOOX
XOOOOOODDDDDOOOOOOX
XOOOOOODOMODOOOOOOX
XOOOOOODOOODOOOOOOX
XXXXXXXXXXXXXXXXXXX