XXXXXXXXXXXXXXXXXXXX
XOOOOOOOOEOOOOOOOOOX
XOOOOOOOOOOOOOOOOOOX
XOODOOOOOODOOOOOWWOX
XOODOOOOOODOOOOOWWOX
XOODOOOOOODOOOOOWWOX
XOODDDDDOODOOOOOWWOX
XOODOOOOOODOOOOOWWOX
XOODOOODDDDDDOOOWWOX
XOODOOODOOOOOOOOWWOX
XOODOOODOOOOOOOOWWOX
XOODOOODOOOOOOOOWWOX
XOODOOODOOOOOOOOWWOX
XOOOOOOOOOOOOOOOWWOX
XOOOOOOOOOOOOOOOWWOX
XOOOOOOOOOOOOOOOWWOX
XOOOOPODDDDDOPOOOOOX
XOOOOOODOOODOOOOOOOX
XOOOOOODOMODOOOOOOOX
XOOOOOODOOODOOOOOOOX
XXXXXXXXXXXXXXXXXXXX